1111111
10P0C01
1110101
1E000C1
1111111