1111111
10P0001
1110101
1E00001
1111111