1111111111111
1EG00000000C1
1010101C1011
1010101C1011
1P0000000001
111111111111
