1111111111111
10000000000C1
1010101C10101
1010101C10101
1P00000000001
1111111111111
